NO ./textures/cheminee.xpm
SO ./textures/sapin.xpm
WE ./textures/noelvert.xpm
EA ./textures/noelflocon.xpm
F 50,15,5
C 10,40,10
D ./textures/porterouge.xpm
P ./textures/perenoel.xpm
A ./textures/ecurie.xpm



1111111111111111111111111
1000000000110000000000001
1011000001110000D0W000001
100100000000000000000000111111111
111110111011000001110000000000001
100000000011000001110111111111111
1111D111111111011100000011P11
11110111111111011101010010001
11000000110101011100000010001
100000011100000011000000D0001
10000001 10000001101010110001
11000001110101011111011100001
1111A111 1110101 101111110001
11111111 1111111 111111111111
